{
    "Theme": "Brick Kingdom",
    "Data":
    [
        [
            15, 15, 15, 15, 15, 15, 15,  1
        ],
        [
            15, 15, 15, 15, 15, 15, 15,  1
        ],
        [
            15, 15, 15, 15, 15,  2,  2,  1
        ],
        [
            15, 15, 15,  2,  2,  3,  2,  1
        ],
        [
            15, 15, 15, 15,  5,  5,  4,  1
        ],
        [
            15, 15, 15, 15,  6, 15, 15,  1
        ],
        [
            15, 15, 15, 15,  6, 15, 15,  1
        ],
        [
            15, 15, 15, 15,  6, 15, 15,  1
        ],
        [
            15, 15, 15, 15, 15, 15,  7,  1
        ]
    ]
}