{
    "Theme": "Overworld",
    "Data":
    [
        [
            32, 32, 32, 32, 32, 32, 32,  1
        ],
        [
            32, 32, 32, 32, 32, 32, 32,  1
        ],
        [
            32, 32, 32, 32, 32, 32, 32,  1
        ],
        [
            32, 32, 32, 32, 32, 32,  2,  2
        ],
        [
            32, 32, 32, 32,  2,  2,  2,  2
        ],
        [
            32, 32, 8, 32,  32, 32, 32,  1
        ],
        [
            32, 32, 32, 32,  3, 32, 32,  1
        ],
        [
            32,  8, 32, 32,  3, 32, 32,  1
        ],
        [
            32, 32, 32, 32, 32, 32,  7,  1
        ],
        [
            32,  2, 32, 32, 32,  2,  2,  2
        ],
        [
            32, 32, 32, 32, 32, 32, 32,  1
        ],
        [
            32, 32, 32, 32, 32, 32, 32,  1
        ],
        [
            32, 32, 32, 32, 32, 32, 32,  1
        ],
        [
            32, 32, 32, 32, 32, 32, 32,  1
        ],
        [
            32, 32, 32, 32, 32, 32, 32,  1
        ],
        [
            32, 32, 32, 32, 32, 32, 32,  1
        ],
        [
            32, 32, 32, 32, 32, 32, 32,  1
        ],
        [
            32, 32, 32, 32, 32, 32, 32,  1
        ],
        [
            32, 32, 32, 32, 32, 32, 32,  1
        ],
        [
            32, 32, 32, 32, 32, 32, 32,  1
        ],
        [
            32, 32, 32, 32, 32, 32, 32,  1
        ],
        [
            32, 32, 32, 32, 32, 32, 32,  1
        ],
        [
            32, 32, 32, 32, 32, 32, 32,  1
        ]
    ]
}